UID,Name,NationID,Born,Age,IntCaps,IntGoals,U21Caps,U21Goals,Height,Weight,AerialAbility,CommandOfArea,Communication,Eccentricity,Handling,Kicking,OneOnOnes,Reflexes,RushingOut,TendencyToPunch,Throwing,Corners,Crossing,Dribbling,Finishing,FirstTouch,Freekicks,Heading,LongShots,Longthrows,Marking,Passing,PenaltyTaking,Tackling,Technique,Aggression,Anticipation,Bravery,Composure,Concentration,Vision,Decisions,Determination,Flair,Leadership,OffTheBall,Positioning,Teamwork,Workrate,Acceleration,Agility,Balance,Jumping,LeftFoot,NaturalFitness,Pace,RightFoot,Stamina,Strength,Consistency,Dirtiness,ImportantMatches,InjuryProness,Versatility,Adaptability,Ambition,Loyalty,Pressure,Professional,Sportsmanship,Temperament,Controversy,PositionsDesc,Goalkeeper,Sweeper,Striker,AttackingMidCentral,AttackingMidLeft,AttackingMidRight,DefenderCentral,DefenderLeft,DefenderRight,DefensiveMidfielder,MidfielderCentral,MidfielderLeft,MidfielderRight,WingBackLeft,WingBackRight
1000055,Wilfred Bamnjo,11,27-03-1980,36,0,0,0,0,178,79,1,1,2,2,3,3,1,4,1,2,1,3,8,6,9,12,4,4,9,1,6,6,2,12,9,15,8,13,6,12,9,6,9,7,10,4,9,5,12,9,7,7,11,12,12,6,20,5,12,11,15,8,7,4,20,6,3,9,3,10,14,11,DM ,1,1,1,1,1,1,1,1,1,20,11,1,1,1,1
1000331,Wang Wei,110,20-02-1982,34,0,0,0,0,188,90,12,3,5,1,12,6,2,1,6,6,5,3,1,2,3,1,6,1,1,1,3,1,3,2,1,6,1,12,3,3,2,12,5,2,8,1,8,3,2,5,13,5,9,11,5,8,20,1,7,6,6,6,6,6,14,10,7,11,11,12,10,6,GK ,20,1,1,1,1,1,1,1,1,1,1,1,1,1,1
1000334,Liu Yang,110,11-04-1982,34,0,0,0,0,183,70,1,2,4,2,1,1,1,3,3,2,2,3,3,2,4,10,3,1,8,1,5,8,2,10,6,5,6,4,4,4,2,5,5,5,8,3,6,6,9,7,4,4,8,5,8,6,20,4,9,5,5,5,5,5,9,11,14,7,11,13,10,8,DM ,1,1,1,1,1,1,1,1,1,20,1,1,1,1,1
1000337,Song Qi,110,07-04-1985,31,0,0,0,0,170,65,1,3,1,3,2,2,1,2,3,3,1,3,2,6,7,9,3,13,1,1,2,3,2,1,9,6,10,1,3,4,1,7,6,9,12,11,2,3,4,11,7,2,6,2,8,7,20,6,6,6,6,2,5,6,16,13,11,9,10,13,13,7,S ,1,1,20,1,1,1,1,1,1,1,1,1,1,1,1
1000340,Chen Lei,110,20-01-1983,33,0,0,0,0,181,70,3,3,2,3,1,1,3,3,2,1,3,1,1,2,12,5,1,12,2,1,1,2,4,1,3,5,4,4,5,2,2,8,5,5,12,9,1,1,2,9,4,2,6,5,5,8,20,2,5,5,5,5,5,5,13,11,9,10,12,10,19,8,S ,1,1,20,1,1,1,1,1,1,1,1,1,1,1,1
1000350,Jin Taiyun,110,13-02-1985,31,0,0,0,0,175,68,2,2,3,1,3,2,3,2,3,1,3,3,5,4,1,7,1,2,3,4,4,3,1,9,6,5,5,5,5,7,5,8,5,5,13,5,6,5,7,7,6,2,7,5,9,9,20,11,7,5,5,5,5,5,14,12,10,11,13,10,18,5,D/WB R,1,1,1,1,1,1,1,1,16,1,1,1,1,1,20
1000438,Huang Yang,111,19-10-1983,32,3,0,0,0,176,72,1,2,2,3,1,2,2,2,2,3,3,9,11,11,6,12,7,7,7,9,8,10,6,7,11,11,11,13,10,12,10,11,13,8,14,10,10,12,13,9,10,12,6,9,12,8,20,13,8,14,6,15,3,9,13,12,13,13,15,14,17,2,DM/M RC,1,1,1,1,1,2,9,1,1,20,17,1,18,1,1
1000443,Xu Wanchun,110,07-02-1985,31,0,0,0,0,184,0,3,3,1,2,3,3,1,1,1,2,1,10,12,6,3,9,6,3,5,4,4,7,3,5,10,6,5,5,4,5,7,5,6,6,11,5,3,7,11,11,7,5,10,6,13,8,20,6,7,6,4,5,6,6,12,10,11,10,10,10,17,2,M R,1,1,1,1,1,1,1,1,1,1,1,1,20,1,1
1001575,Liu Quankun,111,17-02-1983,33,5,0,0,0,186,85,2,2,2,1,2,3,3,2,3,1,1,2,2,5,3,8,4,9,6,1,11,4,6,10,4,12,11,10,5,6,4,7,12,4,10,3,11,9,9,6,12,8,8,8,9,6,20,11,12,12,17,6,5,8,13,13,13,7,13,2,2,16,D RC,1,1,1,1,1,1,20,10,17,13,1,1,1,1,1
1001579,Zhù Yifan,110,01-03-1988,28,0,0,0,0,182,72,1,4,3,1,3,2,1,2,2,3,2,5,6,12,5,9,9,7,10,5,6,10,4,9,11,12,9,8,5,7,11,9,12,7,5,14,7,12,11,11,12,10,11,8,7,11,20,11,12,11,6,8,4,6,14,10,12,10,5,12,18,7,M/AM C,1,1,1,20,1,1,1,1,1,15,17,1,1,1,1
1001581,Li Zhuangfei,110,24-01-1988,28,0,0,0,0,177,70,2,3,3,2,1,3,2,3,2,2,1,6,10,9,6,9,7,8,7,5,8,7,4,8,9,9,9,8,9,8,11,10,1,9,7,7,9,11,10,10,10,6,7,8,12,10,20,9,8,8,8,7,7,9,8,12,11,13,10,9,7,10,DM/M C,1,11,1,1,1,1,15,1,11,20,18,1,10,1,1
1001583,Zheng Long,110,15-04-1988,28,7,3,0,0,178,75,3,3,2,1,2,3,3,3,1,1,1,12,13,13,13,12,12,5,12,7,5,12,9,5,12,13,12,12,13,13,11,12,15,15,8,12,6,15,13,13,13,12,8,20,16,12,3,13,11,10,13,15,5,12,16,13,13,15,15,8,12,8,M/AM LC,1,1,12,18,20,13,1,1,1,1,12,18,11,1,1
1001587,Deng Zhuoxiang,110,24-10-1988,27,30,8,0,0,181,70,3,1,2,1,1,1,1,3,2,2,1,11,12,11,10,11,15,8,11,8,3,12,11,5,11,7,12,9,12,9,11,12,13,15,5,12,5,10,8,9,10,8,6,20,5,9,6,8,6,7,10,12,18,14,7,11,13,13,14,15,14,6,AM RLC,1,1,1,20,16,16,1,1,1,5,11,12,12,1,1
1001589,Gu Jinjin,110,14-04-1989,27,0,0,0,0,180,75,1,2,4,1,1,2,3,1,1,2,2,5,9,6,7,8,5,9,6,3,3,4,5,4,5,7,10,6,9,6,10,14,7,13,7,7,7,7,10,8,7,6,5,12,10,7,20,8,4,7,7,3,12,7,17,10,11,20,18,18,14,9,AM/S R,1,1,20,1,1,20,1,1,1,1,1,1,1,1,1
1001591,Li Xuepeng,110,18-09-1988,27,19,0,0,0,181,75,1,1,1,1,3,1,3,2,2,2,2,8,12,10,9,10,8,12,7,12,8,11,5,9,10,10,7,12,8,7,8,9,9,8,9,11,8,11,8,12,11,14,11,20,7,12,12,10,12,9,8,8,14,15,12,11,14,8,10,8,6,11,D/M/AM LC,1,1,1,1,17,1,18,20,1,14,1,16,1,9,1
1001593,Zhang Xu,110,19-05-1988,28,0,0,0,0,175,67,1,1,3,3,3,2,1,3,1,3,2,1,2,5,3,5,3,7,1,2,4,4,1,7,3,7,5,6,4,9,1,9,4,7,10,5,4,4,5,12,12,4,2,6,7,12,20,9,5,7,6,5,7,7,12,10,12,11,10,14,14,6,D R,1,1,15,1,1,1,1,1,20,1,1,1,1,1,1
1002238,Ken'ichi Sekino,116,24-05-1967,49,0,0,0,0,171,0,3,3,1,2,1,2,3,2,1,3,2,7,11,5,4,9,4,2,6,2,4,8,3,3,9,6,5,2,7,4,4,8,3,4,13,6,4,7,11,8,6,4,7,5,7,7,20,10,4,6,6,6,6,6,12,13,10,13,9,11,15,8,M RL,1,1,1,1,1,1,1,1,1,1,1,17,20,1,1
1002291,Hon Shing,111,14-04-1987,29,0,0,0,0,175,64,1,3,2,1,1,3,3,2,3,3,2,4,4,3,6,5,1,1,6,1,4,9,3,3,7,7,7,6,7,4,12,12,5,7,9,8,5,6,11,13,12,3,8,5,10,12,20,8,7,7,7,5,5,7,14,11,11,11,12,9,11,3,AM C,1,1,1,20,1,1,1,1,1,1,1,1,1,1,1
1002306,Amro Abbas,16,22-05-1987,29,0,0,0,0,177,73,1,1,4,1,3,1,2,3,3,3,2,8,10,4,6,9,4,5,5,1,3,5,1,3,8,4,3,1,3,4,4,8,7,9,12,8,2,4,6,12,12,4,4,8,10,12,20,10,3,7,5,7,7,7,20,11,11,9,10,6,10,8,M/S RLC,1,1,16,1,1,1,1,1,1,1,16,20,15,1,1
1002438,James-John Daws,765,29-05-1978,38,0,0,0,0,194,88,1,3,1,1,3,1,1,1,3,3,2,3,1,3,10,4,1,12,4,1,3,3,2,1,4,6,3,1,9,1,3,4,2,7,9,7,4,3,4,12,11,1,10,6,9,11,20,5,11,7,4,3,6,7,7,11,11,9,10,11,19,6,S ,1,1,20,1,1,1,1,1,1,1,1,1,1,1,1
1002443,Fofo,111,30-06-1979,37,11,0,0,0,175,70,2,3,2,3,1,1,4,2,3,1,3,4,5,6,4,6,4,8,6,5,10,6,7,10,6,10,9,13,11,10,7,9,3,7,13,8,12,12,12,7,9,11,9,8,8,7,20,10,10,10,7,9,8,12,13,6,13,11,13,10,12,6,D/DM C,1,1,1,1,1,1,16,1,12,20,1,1,1,1,1
1002454,Stéphane Ambassa,11,23-07-1982,33,0,0,0,0,188,84,3,2,3,1,1,2,3,4,2,4,3,3,1,8,10,12,3,8,4,1,2,4,3,2,7,3,9,10,6,3,3,7,7,8,10,10,4,3,4,10,7,4,7,11,13,9,20,8,11,7,7,7,7,6,11,8,8,11,8,13,12,8,S ,1,1,20,1,1,1,1,1,1,1,1,1,1,1,1
1002678,Wong Chi Chung,111,11-10-1982,33,0,0,0,0,180,76,3,2,3,1,3,1,1,1,3,1,3,5,7,6,7,10,2,11,8,10,7,7,7,9,6,6,8,11,7,8,4,9,1,6,12,7,11,11,9,8,7,11,8,6,10,9,20,11,10,7,15,7,7,7,10,13,12,12,11,10,12,7,D RC,1,5,1,1,1,1,18,1,20,1,1,1,1,1,1
1002811,Le Beisi,110,11-10-1981,34,0,0,0,0,182,77,3,3,2,3,1,3,2,3,2,3,1,11,8,6,6,7,11,3,10,3,7,8,4,9,8,12,9,6,7,9,8,9,7,10,15,7,8,10,11,6,9,9,6,11,9,5,20,9,8,17,9,15,7,7,9,11,13,12,13,12,14,8,DM/M/AM C,1,1,1,18,1,1,1,1,1,20,17,1,1,1,1
1002833,Chen Dong,110,10-07-1982,33,0,0,0,0,183,75,1,4,1,3,3,1,1,4,1,2,1,7,5,6,8,6,5,10,8,1,5,7,3,5,7,8,5,10,6,8,6,8,14,10,7,12,5,8,12,6,11,6,11,11,7,8,20,9,11,13,3,6,7,7,19,10,15,10,12,11,10,1,S ,1,1,20,10,1,1,1,1,1,1,1,1,1,1,1
1002839,Pan Min,110,02-05-1981,35,0,0,0,0,182,82,2,2,1,3,2,1,2,1,1,1,3,3,2,6,13,7,4,10,5,1,3,5,9,1,7,7,5,1,10,5,5,13,7,7,13,13,4,4,6,9,8,5,9,2,9,9,20,10,8,7,6,5,7,7,16,12,11,11,11,11,10,4,S ,1,1,20,1,1,1,1,1,1,1,1,1,1,1,1
1002842,Ye Jia,111,01-12-1981,34,6,0,0,0,180,75,1,2,3,2,4,1,4,3,3,1,1,8,7,9,10,10,11,8,13,3,8,7,7,7,9,13,6,9,9,11,7,12,13,11,5,7,9,10,9,9,7,11,8,8,6,7,20,10,12,8,7,2,5,14,19,15,12,9,12,8,8,3,AM/S C,1,1,18,20,7,8,5,1,8,13,15,1,1,1,1
1002850,Liu Meng,110,12-11-1980,35,0,0,0,0,176,73,3,1,2,2,2,2,2,1,2,2,2,4,8,4,13,9,4,12,5,1,8,5,4,10,6,7,7,6,8,5,1,12,3,7,11,10,4,4,5,9,7,11,4,11,13,8,20,9,5,7,7,2,7,7,9,11,13,11,10,10,16,2,S ,1,1,20,1,1,1,1,1,1,1,1,1,1,1,1
1002854,Xu Xin,110,12-11-1981,34,0,0,0,0,180,69,2,2,3,1,1,3,1,2,1,3,1,3,1,1,2,4,1,8,4,1,9,5,4,7,3,5,7,6,6,5,1,8,5,1,10,4,6,4,6,7,7,6,8,20,10,8,5,11,7,5,5,1,5,5,20,10,10,14,12,12,10,6,D LC,1,1,1,1,1,1,20,17,1,1,1,1,1,1,1
1002901,Han Kun,110,16-01-1983,33,0,0,0,0,188,84,9,12,11,5,10,9,10,9,13,5,13,4,1,1,1,1,7,1,2,2,1,1,1,3,3,7,5,9,5,9,4,13,1,2,9,1,11,5,4,7,7,13,9,1,13,7,20,4,13,18,7,10,7,7,10,10,10,10,9,11,11,2,GK ,20,1,1,1,1,1,1,1,1,1,1,1,1,1,1
1002903,Li Jun,110,23-05-1984,32,0,0,0,0,184,75,2,3,3,1,2,3,1,3,3,2,1,3,1,1,1,3,1,11,1,1,13,1,1,8,1,6,4,6,4,6,1,6,6,2,14,2,8,3,6,6,10,4,6,6,12,8,20,11,8,6,6,6,6,6,9,11,8,10,10,11,17,8,D C,1,1,1,1,1,1,20,1,1,1,1,1,1,1,1
1002915,Xie Junhui,110,18-09-1984,31,0,0,0,0,175,68,1,2,1,3,2,2,2,3,3,3,3,3,3,2,10,9,3,13,4,2,3,4,5,1,5,6,5,2,5,4,4,7,6,6,11,9,2,3,4,9,7,4,8,6,8,11,20,6,6,6,5,6,4,6,7,10,12,13,10,12,13,7,S ,1,1,20,1,1,1,1,1,1,1,1,1,1,1,1
1002918,Ji Jun,110,27-12-1985,30,0,0,0,0,189,84,1,2,1,3,3,2,1,3,1,1,3,2,1,4,9,9,1,12,6,1,9,9,5,11,6,13,8,13,8,5,9,8,11,8,6,9,8,9,8,9,5,13,10,8,9,9,20,10,13,9,7,9,6,9,11,19,12,11,18,11,11,10,DM/S ,1,1,20,2,10,9,2,1,1,18,10,7,6,1,1
1002921,Liu Yingkun,110,10-09-1984,31,0,0,0,0,181,72,3,2,2,3,1,2,3,3,2,3,2,2,4,3,1,5,1,6,6,1,13,6,4,10,4,7,8,6,6,6,4,13,1,7,7,5,6,5,6,6,7,5,9,7,14,5,20,10,5,7,5,7,7,7,8,11,10,13,9,11,19,1,D/DM/M C,1,1,1,1,1,1,20,1,1,18,17,1,1,1,1
1002959,Zhang Qi,110,18-01-1982,34,0,0,0,0,175,68,3,3,3,3,2,1,2,1,2,3,2,1,1,1,1,9,1,3,12,1,5,10,1,11,5,6,7,5,5,5,7,8,1,5,9,4,7,4,8,10,7,1,7,6,6,8,20,11,6,6,6,5,6,6,9,10,8,12,14,10,10,1,DM/M C,1,1,1,1,1,1,1,1,1,20,18,1,1,1,1
1002967,Zhang Yue,110,18-03-1986,30,0,0,0,0,182,62,2,4,1,2,4,4,3,2,1,3,3,2,2,4,7,7,2,4,1,1,2,3,1,1,6,6,5,4,4,3,2,4,6,7,11,5,4,3,5,12,12,4,6,8,10,12,20,10,4,6,6,6,6,6,10,13,11,12,10,15,20,5,AM/S C,1,1,18,20,1,1,1,1,1,1,11,1,1,1,1
1002969,Zhang Li,110,24-01-1981,35,0,0,0,0,182,65,3,3,1,1,2,3,1,3,3,2,1,1,1,1,1,4,1,8,3,1,13,3,1,8,1,6,5,6,3,5,3,8,6,2,12,3,10,3,4,8,6,4,6,9,11,6,20,8,6,6,6,6,6,6,8,14,9,13,14,10,16,3,D C,1,1,1,1,1,1,20,1,1,1,1,1,1,1,1
1003004,Li Hènan,110,02-04-1985,31,0,0,0,0,185,80,3,3,1,1,1,4,2,2,3,1,1,1,1,2,1,3,1,5,1,1,12,3,1,10,1,6,4,4,1,7,1,12,4,6,1,2,6,2,3,3,8,3,10,5,13,7,20,3,5,6,6,6,6,6,19,13,10,11,13,10,18,5,D C,1,1,1,1,1,1,20,1,1,1,1,1,1,1,1
1003011,Zhang Tinghui,110,27-07-1985,30,0,0,0,0,180,68,3,1,2,3,3,3,2,1,2,1,2,1,2,9,2,4,1,1,1,1,1,1,1,1,4,5,1,1,1,1,3,5,3,6,12,2,1,4,7,11,9,2,6,5,8,11,20,11,4,6,6,6,3,6,19,10,12,8,12,12,20,3,AM RL,1,1,1,1,20,20,1,1,1,1,1,3,5,1,1
1003016,Wang Zedong,110,06-09-1985,30,0,0,0,0,175,75,1,1,2,1,3,2,2,2,3,2,3,2,1,1,3,3,2,8,1,1,9,4,1,11,1,6,9,6,3,6,1,9,6,6,4,3,10,3,4,8,9,4,5,6,10,8,20,9,3,6,6,1,4,6,13,10,13,13,13,9,13,2,D C,1,1,1,1,1,1,20,1,1,1,1,1,1,1,1
1003050,Yang Yu,110,18-04-1985,31,0,0,0,0,186,75,1,1,1,3,1,2,3,1,3,3,3,5,8,9,12,9,7,10,7,3,7,8,4,5,10,16,11,6,10,8,8,12,3,9,6,12,8,13,13,10,9,9,11,10,13,10,20,8,8,9,6,2,12,9,17,11,8,12,10,9,13,6,M/S RC,1,1,20,14,1,1,10,6,1,1,16,14,15,1,1
1003053,Ma Wei,110,09-04-1985,31,0,0,0,0,178,70,2,3,3,1,2,1,2,3,2,1,3,5,8,8,4,10,5,5,3,5,5,6,1,6,10,7,6,5,8,6,5,8,2,7,13,5,5,7,10,14,7,6,4,20,9,10,1,14,6,7,3,4,7,7,17,13,12,11,11,13,12,5,M L,1,1,1,1,1,1,1,1,1,1,1,20,1,1,1
1003103,Pu Tshering,110,03-10-1982,33,0,0,0,0,173,67,1,2,3,2,1,3,2,2,1,2,1,4,8,3,4,9,3,1,3,4,4,3,1,3,6,6,5,5,5,3,6,10,6,5,5,5,4,7,11,12,10,5,6,20,11,11,6,11,3,6,4,6,6,6,20,11,9,12,14,11,17,1,M L,1,1,1,1,1,1,1,1,1,1,1,20,1,1,1
1003133,Jamcun,110,09-08-1982,33,0,0,0,0,176,64,6,6,8,1,6,6,6,9,6,6,7,2,1,2,3,1,1,1,1,3,2,2,2,1,1,6,6,12,4,8,2,4,3,2,13,3,6,4,3,13,12,4,4,6,9,12,20,1,3,6,6,6,6,5,10,10,14,9,12,10,20,4,GK ,20,1,1,1,1,1,1,1,1,1,1,1,1,1,1
1003222,Li Xiao,110,18-04-1985,31,0,0,0,0,183,69,2,2,2,3,2,3,3,1,2,3,3,1,1,4,11,11,1,11,2,1,2,2,2,1,8,6,6,3,7,1,2,8,5,10,13,8,2,2,3,11,7,1,7,6,14,10,20,8,6,7,16,6,5,7,13,8,9,11,12,14,20,3,S ,1,1,20,1,1,1,1,1,1,1,1,1,1,1,1
1003231,Hu Jun,110,15-09-1985,30,0,0,0,0,178,68,1,3,3,2,1,2,2,2,1,1,1,2,1,6,12,5,2,12,2,1,2,3,3,1,4,6,5,1,6,3,3,8,5,6,8,11,2,2,4,12,9,3,6,8,6,10,20,9,10,6,4,6,6,6,15,11,13,11,12,8,10,3,S ,1,1,20,1,1,1,1,1,1,1,1,1,1,1,1
1003681,Tse Tak Him,111,10-02-1985,31,9,0,0,0,181,72,7,10,11,8,11,7,9,11,8,14,12,3,2,2,2,1,5,1,2,3,2,10,2,3,2,8,10,13,5,8,5,8,5,2,10,2,10,6,5,11,8,6,9,8,14,10,20,2,6,10,4,5,4,8,18,8,10,11,11,11,17,2,GK ,20,1,1,1,1,1,1,1,1,1,1,1,1,1,1
1003777,Chui Yiu Chung,111,17-02-1983,33,0,0,0,0,174,62,2,3,1,3,2,2,3,3,1,4,1,9,12,5,5,10,5,4,6,5,3,6,1,4,11,7,8,5,7,6,8,12,7,10,13,6,4,7,12,9,8,6,6,8,14,11,20,8,6,7,8,7,7,7,15,12,13,10,11,9,18,5,AM R,1,1,1,1,1,20,1,1,1,1,1,1,14,1,1
1003796,Cheng Chi Wing,111,17-04-1983,33,0,0,0,0,179,64,1,2,3,3,2,2,4,3,3,3,1,10,11,6,4,13,5,7,8,1,10,10,3,9,10,7,8,8,6,6,9,10,8,7,10,5,7,7,12,4,7,6,4,6,10,5,20,12,7,12,4,7,4,7,16,5,11,9,10,9,19,7,M C,1,1,1,1,1,1,1,1,1,1,20,1,1,1,1
1004803,Asraf Abdul Rashid,134,27-08-1985,30,0,0,0,0,168,64,2,2,1,3,1,2,3,3,2,3,1,12,12,6,4,6,10,1,4,1,7,8,2,5,10,13,6,14,5,9,8,5,20,8,1,10,6,12,13,10,12,13,2,20,16,8,8,11,2,9,8,3,8,13,11,12,11,10,12,9,5,1,M/AM L,1,1,1,1,20,11,1,12,1,1,10,18,11,1,1
1004964,Noor Hadi,134,19-01-1985,31,0,0,0,0,171,61,13,7,7,1,13,5,6,5,7,7,6,2,1,3,1,1,5,1,3,1,1,1,1,3,1,7,6,6,5,6,4,13,4,3,3,2,7,5,4,8,9,5,4,6,13,10,20,1,5,7,7,7,4,7,11,11,10,12,8,11,11,4,GK ,20,1,1,1,1,1,1,1,1,1,1,1,1,1,1
1004968,Fazrul Nawaz,134,17-04-1985,31,80,11,0,0,177,70,2,3,1,3,4,3,1,3,1,2,3,8,6,10,9,8,6,6,7,3,2,6,11,3,9,8,9,8,6,9,6,10,11,12,8,12,9,10,11,12,11,10,5,9,12,10,20,11,8,11,6,8,7,11,13,10,13,13,11,11,13,5,AM/S RL,1,1,20,1,16,16,1,1,1,1,1,1,1,1,1
1004972,Syed Thaha,134,02-05-1985,31,0,0,0,0,173,70,3,2,3,2,3,2,1,2,2,2,2,7,10,8,7,11,4,4,8,7,5,8,3,9,15,7,9,7,9,9,7,6,12,12,5,12,7,9,5,12,8,8,7,20,10,12,8,6,7,9,5,8,8,8,12,12,11,10,11,12,14,6,WB/AM L,1,1,1,1,20,1,1,12,1,1,1,12,1,18,1
1005004,Boubacar Keita,22,20-05-1984,32,0,0,0,0,183,76,2,1,3,2,3,3,3,1,1,2,2,7,9,12,8,9,5,9,12,4,7,12,8,10,10,9,9,10,6,11,9,9,5,1,11,5,9,14,15,11,9,10,12,11,13,12,20,14,12,9,6,4,9,9,15,12,13,14,12,13,14,1,D C,1,8,1,1,1,1,20,1,11,1,10,1,8,1,1
1005066,Duncan Elias,134,14-07-1985,30,0,0,0,0,171,65,1,1,3,2,3,3,4,2,2,4,1,1,5,8,4,7,1,1,3,3,1,4,1,2,9,4,6,4,4,4,4,11,3,10,3,4,3,5,9,12,12,4,1,20,13,12,8,12,5,7,7,7,7,7,15,11,11,10,11,9,17,6,AM L,1,1,10,1,20,1,1,1,1,1,1,1,1,1,1
1005109,Faizal Sa'don,134,01-03-1985,31,0,0,0,0,170,60,1,3,3,2,3,2,1,2,1,1,1,3,3,3,4,11,3,3,5,1,5,9,1,9,7,6,9,5,5,4,7,11,2,6,5,1,7,6,9,6,6,4,6,5,9,7,20,5,4,6,6,6,3,6,13,10,10,11,10,11,11,7,DM/M RC,1,1,1,1,1,1,1,1,1,20,20,1,15,1,1
1005175,Shaiful Esah,134,12-05-1986,30,54,5,0,0,178,70,1,2,3,2,1,1,3,2,2,2,1,14,12,7,5,7,14,5,10,11,8,9,2,8,12,12,9,9,10,9,12,9,7,9,14,10,12,11,11,8,8,11,8,20,10,8,9,10,8,13,9,10,8,8,8,14,10,12,12,9,20,4,D L,1,1,1,1,1,1,1,20,1,1,1,14,1,14,1
1005177,Noor Ikhsan,134,29-06-1986,30,0,0,0,0,186,72,2,2,2,3,2,1,3,2,2,2,2,1,1,1,1,4,1,10,1,1,11,6,1,7,5,8,8,8,6,9,1,7,11,4,13,4,7,5,7,13,11,6,9,8,11,13,20,12,8,8,3,2,8,8,19,12,10,12,12,10,20,1,D C,1,1,1,1,1,1,20,1,1,1,1,1,1,1,1
1005180,Khairul Amri,134,15-03-1985,31,101,29,0,0,173,66,2,1,4,2,2,3,1,2,2,2,3,8,11,13,12,12,12,4,5,4,8,12,9,6,13,9,7,9,9,10,13,8,11,15,8,11,7,11,9,12,7,7,4,13,13,12,20,7,7,13,7,14,12,8,18,15,12,13,10,9,9,7,S ,1,1,20,14,13,12,1,1,1,1,1,1,1,1,1
1005186,Farhan Nabrawi,134,28-02-1985,31,0,0,0,0,174,68,1,2,2,3,1,1,2,3,2,1,2,7,11,4,4,10,6,5,8,6,7,10,1,8,6,7,8,6,8,7,9,10,4,5,10,8,7,8,12,12,10,3,10,7,11,8,20,7,5,7,7,7,7,7,17,10,11,8,11,12,19,2,M LC,1,1,1,1,1,1,1,1,1,1,15,20,1,1,1
1005218,Jeremy Chiang,134,11-04-1985,31,1,0,0,0,182,60,3,3,1,1,1,4,3,2,3,3,3,11,10,8,8,6,7,5,4,7,8,9,1,10,6,12,6,5,8,9,7,12,14,10,7,10,8,9,11,11,8,6,8,14,13,11,20,8,10,11,8,10,7,13,13,14,13,10,10,11,6,8,D/WB R,1,1,1,1,1,1,1,14,20,1,1,1,14,1,16
1005221,Shafuan Sutohmoh,134,05-07-1985,30,0,0,0,0,170,64,3,3,2,1,2,2,3,1,2,3,3,5,2,2,5,7,5,3,8,3,7,7,4,9,8,7,7,12,8,8,10,13,4,6,11,11,11,6,12,9,9,11,7,8,9,9,20,10,8,8,7,7,6,7,10,9,12,11,10,13,10,7,M C,1,1,1,12,1,1,1,1,1,1,20,1,1,1,1
1005272,Xu Kefei,110,13-07-1983,32,0,0,0,0,184,78,3,2,1,2,1,2,3,3,3,3,2,1,1,3,12,9,2,8,2,1,2,1,4,1,5,4,11,3,4,3,1,4,6,6,10,9,3,2,5,12,9,3,4,6,12,7,20,9,7,6,4,6,6,5,19,11,12,13,10,9,19,2,S ,1,1,20,1,1,1,1,1,1,1,1,1,1,1,1
1005274,Wan Lin,110,01-02-1983,33,0,0,0,0,180,68,2,3,3,2,2,3,2,3,1,2,3,4,4,1,3,11,4,4,5,1,5,10,1,9,6,7,5,6,6,3,8,6,3,7,12,4,10,6,9,13,7,5,6,6,7,10,20,6,6,7,7,7,7,7,12,11,11,14,11,9,12,8,DM/M C,1,1,1,1,1,1,1,1,1,18,20,1,1,1,1
1005305,Wei Liang,110,04-05-1985,31,0,0,0,0,185,78,2,1,3,1,1,3,1,3,2,2,3,1,1,1,1,3,1,10,1,1,10,3,1,12,2,6,4,5,2,9,1,12,4,3,13,1,11,2,3,7,6,3,10,6,10,7,20,2,8,6,6,2,6,6,7,11,10,11,13,12,19,3,D C,1,1,1,1,1,1,20,1,1,1,1,1,1,1,1
1005317,Feroz Hussien,134,08-07-1985,30,0,0,0,0,180,62,2,4,2,3,1,1,1,2,1,1,3,1,1,1,1,2,1,7,2,2,10,1,2,9,1,6,8,4,3,4,1,7,1,5,8,1,6,2,3,12,12,3,6,6,13,12,20,7,6,6,6,6,6,6,10,12,12,11,8,12,12,8,D C,1,1,1,1,1,1,20,1,1,1,1,1,1,1,1
1005333,Yusiskandar Yusop,134,15-07-1985,30,0,0,0,0,178,62,3,2,1,3,2,2,3,3,2,4,2,1,1,3,1,1,1,8,4,3,5,1,1,8,6,7,3,7,3,10,3,11,12,2,12,2,6,5,12,14,13,5,5,7,6,13,20,11,5,7,3,4,7,7,18,10,14,10,12,10,11,6,D RC,1,1,1,1,1,1,15,1,20,13,1,1,1,1,14
1005349,Gary Ang,134,15-03-1985,31,0,0,0,0,166,68,1,4,3,1,2,3,1,2,1,1,1,2,3,3,1,5,1,5,3,2,5,1,1,10,3,6,5,6,4,9,2,7,6,6,3,1,8,5,5,12,8,5,1,20,13,9,4,10,4,6,6,6,6,6,8,9,10,14,12,12,15,2,D L,1,1,1,1,1,1,1,20,1,1,1,1,1,1,1
1005387,Jufri Taha,134,04-03-1985,31,3,0,0,0,172,70,3,3,4,2,2,1,2,2,3,3,3,7,7,2,5,8,7,7,7,7,15,7,5,9,5,8,11,4,7,9,7,8,9,6,8,7,15,7,9,6,8,8,7,20,11,7,7,12,8,11,7,8,8,8,20,12,10,10,12,10,20,7,D C,1,1,1,1,1,1,20,1,1,15,14,1,1,1,1
1005471,Azam Hamin,134,09-05-1983,33,0,0,0,0,175,68,5,8,2,1,11,4,4,5,6,6,2,3,3,2,1,1,6,1,3,2,2,1,1,3,1,6,3,14,2,4,1,11,6,2,12,1,5,2,1,9,12,1,1,9,10,6,20,1,2,6,6,6,6,6,12,10,10,13,11,10,10,7,GK ,20,1,1,1,1,1,1,1,1,1,1,1,1,1,1
1005496,Aziz Dolgani,134,18-01-1986,30,0,0,0,0,187,70,2,2,1,1,3,1,1,3,3,3,4,1,1,1,1,3,1,7,1,1,11,3,1,10,2,7,6,6,3,4,1,11,3,3,4,2,9,2,3,11,6,3,10,6,9,10,20,4,7,6,7,5,6,7,15,9,10,11,12,11,12,3,D C,1,1,1,1,1,1,20,1,1,1,1,1,1,1,1
7458500,Lionel Messi,1649,24-06-1987,29,113,55,18,14,170,72,4,3,3,1,2,1,3,1,3,1,2,15,16,20,20,19,19,11,17,4,4,20,17,8,20,7,19,10,18,13,20,20,20,20,13,16,5,14,7,18,20,20,6,20,14,15,14,13,9,17,9,18,10,12,17,20,13,19,16,15,14,6,AM/S RC,1,1,20,19,11,20,1,1,1,1,12,8,8,1,1
7458896,Álex González,796,13-03-1984,32,0,0,0,0,179,80,3,2,3,1,1,1,2,3,3,2,2,4,5,6,3,9,7,14,6,5,10,7,4,9,9,14,10,14,9,8,5,7,3,8,13,6,10,12,12,8,7,11,14,3,11,7,20,13,16,13,12,10,6,5,8,9,11,12,11,9,19,5,D C,1,10,1,1,1,1,20,1,1,1,1,1,1,1,1
7458914,Abraham,796,16-07-1985,30,0,0,0,0,174,70,3,2,1,1,2,1,2,1,1,1,3,9,10,10,7,14,10,12,10,10,13,14,8,13,11,13,10,15,12,14,12,12,11,10,8,12,14,14,13,13,13,13,12,12,15,13,20,15,11,13,10,11,8,10,12,13,11,9,11,9,11,4,M C,1,1,1,15,1,1,1,1,1,14,20,1,1,1,1
7459574,Andreu Guerao,796,17-06-1983,33,0,0,0,0,179,65,4,1,3,2,3,2,4,2,1,1,2,8,10,12,6,12,8,10,8,5,10,12,10,13,14,12,14,10,13,11,12,11,12,12,10,9,11,14,10,10,11,9,11,8,9,10,20,11,8,15,8,6,13,9,12,10,12,10,16,16,14,4,DM/M C,1,1,1,10,1,1,1,1,1,20,19,1,1,1,1
7459580,Oriol Riera,796,03-07-1986,29,0,0,0,0,185,78,2,1,1,3,3,3,1,2,3,4,3,5,8,12,14,9,8,15,12,5,3,10,13,6,11,13,13,11,12,12,9,12,11,10,9,12,9,14,14,12,13,14,12,12,15,13,20,15,14,13,6,11,8,13,5,9,10,9,12,9,9,4,S ,1,1,20,1,1,1,1,1,1,1,1,1,1,1,1
19024412,Neymar,1651,05-02-1992,24,70,46,7,9,174,68,2,3,2,1,3,1,2,3,1,1,3,16,16,20,16,17,16,9,13,3,4,16,16,4,20,10,17,14,15,15,16,15,15,19,13,19,4,13,12,18,19,14,6,15,16,16,20,13,10,14,11,15,6,12,15,16,19,14,15,8,8,17,M/AM/S LC,1,1,19,18,20,14,1,1,1,1,1,18,12,1,1
19024501,Gábor Gyömbér,773,27-02-1988,28,1,0,0,0,179,75,1,1,2,2,3,1,3,3,1,1,2,5,6,5,7,10,7,12,7,8,12,11,8,13,11,11,11,7,11,11,9,10,10,10,8,9,12,13,15,10,11,13,8,20,10,9,10,15,12,13,10,10,10,10,10,13,11,8,11,4,11,7,D/DM/M C,1,1,1,10,1,1,17,1,12,20,18,5,5,1,7
19024502,Artur Papizsanszkij,773,30-04-1988,28,0,0,0,0,190,88,1,1,3,3,1,3,3,1,3,3,1,1,4,7,7,6,6,14,7,3,12,8,1,11,8,14,9,14,6,8,6,8,15,9,7,6,11,13,12,8,6,12,14,10,15,8,20,13,15,9,6,7,8,9,9,11,11,10,13,8,19,6,D C,1,1,1,1,1,1,20,1,1,15,1,1,1,1,1
19024780,Juliano,1651,07-03-1989,27,0,0,0,0,189,89,12,14,12,11,13,11,12,14,13,12,11,9,2,1,3,9,11,2,3,1,3,4,5,2,9,10,12,12,11,12,9,12,12,10,13,10,11,12,12,12,13,13,16,10,13,11,20,13,13,11,10,11,8,11,11,12,12,4,12,8,11,11,GK ,20,1,1,1,1,1,1,1,1,1,1,1,1,1,1
19024787,Xandão,1651,23-02-1988,28,0,0,0,0,193,88,2,3,2,1,1,1,3,4,2,1,2,4,5,8,5,10,6,14,5,3,13,10,4,11,11,11,14,14,12,13,6,10,15,6,13,11,14,14,13,11,10,12,16,9,14,13,20,14,16,14,10,12,9,11,7,16,6,13,9,12,12,11,D C,1,1,1,1,1,1,20,1,9,1,1,1,1,1,1
19024791,Dimas,1651,09-02-1989,27,0,0,0,0,187,78,3,1,3,1,2,2,1,3,2,1,2,6,5,7,7,14,2,6,4,3,10,14,1,7,13,8,7,7,5,6,10,12,4,8,1,7,10,7,11,14,14,7,13,2,15,14,20,12,9,8,8,8,8,8,7,12,11,11,12,2,14,3,DM/M C,1,1,1,1,1,1,1,1,1,20,16,1,1,1,1
19024794,Vitor Rossini,1651,06-01-1988,28,0,0,0,0,190,84,1,4,3,3,3,2,2,1,3,2,2,8,8,4,9,12,8,8,8,8,10,14,5,9,10,8,13,9,7,4,14,10,3,8,11,9,12,9,11,14,10,9,16,11,12,14,20,9,11,11,10,4,10,10,15,12,12,11,11,11,12,1,DM C,1,1,1,1,1,1,1,1,1,20,15,1,1,1,1
19024799,Rogério Onofre,1651,23-04-1990,26,0,0,0,0,182,67,1,2,2,2,1,1,3,2,3,3,1,10,11,12,6,9,14,5,7,10,1,10,10,1,10,7,10,8,9,8,10,10,8,7,9,10,5,7,10,12,12,10,11,7,5,13,20,8,9,5,7,8,5,5,20,11,12,12,11,9,16,5,AM RL,1,1,1,12,16,20,1,1,1,1,1,1,1,1,1
19024800,Talles,1651,13-03-1989,27,0,0,0,0,180,74,2,3,1,4,3,2,1,2,3,2,1,5,8,13,8,13,8,8,8,6,4,8,10,7,14,12,12,11,10,10,12,12,12,15,11,11,5,11,11,14,14,9,10,8,15,15,20,11,8,11,7,11,7,9,18,14,15,13,11,12,13,11,AM RL,1,1,8,1,20,20,1,1,1,1,1,1,1,1,1
85139014,Kylian Mbappé,769,20-12-1998,17,0,0,0,0,178,68,2,1,2,1,3,3,3,1,3,3,2,10,11,15,12,13,10,8,9,2,3,12,12,3,16,11,9,11,12,9,12,10,17,17,9,13,5,9,13,15,14,11,9,8,14,14,20,12,9,14,7,15,7,13,13,19,12,16,15,14,14,7,AM RL,1,1,14,1,20,18,1,1,1,1,1,14,12,1,1
85139131,Alassane N'Diaye,769,14-06-1991,25,0,0,0,0,180,68,2,3,4,1,3,3,1,3,4,1,3,6,10,12,10,10,8,11,11,6,4,11,10,4,11,10,12,11,10,9,10,9,10,12,7,12,8,11,11,14,13,12,10,8,14,13,20,14,7,13,10,12,8,7,12,11,7,10,8,12,13,1,AM RL,1,1,15,1,19,20,1,1,1,1,1,1,1,1,1
85139141,Naby Damba,23,01-03-1993,23,0,0,0,0,170,73,3,1,1,4,3,4,1,1,4,1,1,8,7,11,8,9,8,15,9,4,8,11,7,4,12,5,9,5,11,9,9,13,9,9,13,10,8,8,9,11,10,11,6,9,13,11,20,8,11,8,9,9,9,9,13,11,12,12,14,11,10,1,S ,1,1,20,10,10,10,1,1,1,1,1,1,1,1,1
85139142,Djibril Dianessy,769,29-03-1996,20,0,0,0,0,185,73,2,1,2,1,2,3,3,2,3,4,1,7,4,14,10,12,6,14,8,5,5,8,6,1,11,9,13,7,8,8,8,9,3,10,12,14,6,7,8,12,10,12,10,5,13,12,20,11,8,9,4,9,14,9,14,11,8,9,12,8,19,6,S ,1,1,20,1,1,1,1,1,1,1,1,1,1,1,1
19024089,Ronaldinho,1651,06-06-1988,28,0,0,0,0,187,0,1,1,3,3,1,2,1,2,1,2,3,4,7,9,8,14,7,6,8,3,8,9,6,9,9,7,8,3,8,7,10,14,9,8,12,12,9,8,13,14,14,8,8,9,12,14,20,8,8,8,9,9,7,9,12,11,12,13,11,10,10,8,M/AM C,1,1,1,20,1,1,1,1,1,1,16,1,1,1,1
19024188,Hugo,1651,23-12-1988,27,0,0,0,0,183,75,2,2,4,4,1,1,2,1,1,1,1,4,8,7,6,8,4,10,7,4,10,8,9,9,9,13,10,14,7,9,6,8,16,8,11,6,7,11,10,11,12,9,11,20,15,11,7,12,9,10,11,14,11,12,10,19,3,15,14,12,14,9,D C,1,1,1,1,1,1,20,14,1,1,1,1,1,8,1
19024190,Breitner,1658,07-11-1989,26,0,0,0,0,170,63,1,3,1,3,2,3,3,3,3,3,3,11,9,12,10,13,14,4,13,10,8,11,11,8,13,7,11,10,11,12,11,11,8,12,8,12,9,11,9,13,13,6,5,10,12,13,20,13,7,11,12,11,8,16,7,15,12,12,13,9,10,8,M/AM C,1,1,1,20,10,10,1,1,1,1,19,1,1,1,1
19024391,Francisco Alex,1651,23-12-1983,32,0,0,0,0,178,71,1,2,2,2,2,1,1,3,3,1,3,5,12,11,11,10,9,8,13,9,5,12,10,6,12,8,8,7,7,7,13,9,14,11,10,11,6,9,8,13,12,9,8,20,12,14,15,11,9,12,6,8,5,6,7,13,9,8,8,10,12,9,M/AM C,1,1,1,20,1,1,1,1,1,1,16,1,1,1,1
54008400,Tomasz Lewandowski,787,01-06-1989,27,0,0,0,0,194,86,3,4,4,2,3,2,1,4,1,3,2,5,4,6,5,7,5,12,4,8,10,9,5,11,8,10,11,10,11,10,7,12,9,7,14,6,10,12,11,8,9,15,16,8,12,9,20,11,14,13,13,14,9,8,16,12,11,10,11,10,19,1,D C,1,15,10,1,1,1,20,1,13,1,1,1,1,1,1
54008421,Michal Buchalik,787,03-02-1989,27,0,0,0,0,190,83,12,10,13,9,13,7,13,12,8,12,13,3,3,1,3,7,7,5,1,1,3,8,1,1,7,4,10,10,10,12,7,11,15,10,6,6,12,12,11,10,12,12,14,20,11,11,9,11,12,11,4,14,5,10,13,13,16,10,12,12,13,13,GK ,20,1,1,1,1,1,1,1,1,1,1,1,1,1,1
54008517,Robert Wojsyk,787,11-09-1990,25,0,0,0,0,185,75,2,3,1,3,1,3,4,2,1,2,1,5,8,11,7,8,3,10,8,6,6,10,7,6,9,8,10,8,10,10,12,11,9,9,8,10,8,11,13,11,7,10,11,9,9,11,20,12,11,9,7,10,15,7,11,10,11,8,10,12,7,7,S ,1,1,20,10,1,1,1,1,1,1,1,1,1,1,1
54008518,Krzysztof Urbaniak,787,22-10-1990,25,0,0,0,0,188,80,1,1,1,1,3,3,3,2,2,2,1,3,4,6,6,9,2,10,7,6,10,9,4,10,7,9,14,10,8,12,8,8,9,2,14,8,8,8,9,9,8,9,13,7,11,9,20,9,13,10,3,7,5,9,8,8,12,14,10,9,14,6,D C,1,1,1,1,1,1,20,10,10,1,1,1,1,1,1
54008519,Kamil Zalewski,787,16-06-1989,27,0,0,0,0,176,65,2,3,3,1,3,3,1,2,3,2,1,7,10,8,6,9,7,7,7,6,10,10,9,9,11,9,9,12,9,10,10,10,3,9,9,10,9,11,13,11,13,8,8,8,10,11,20,12,8,11,7,10,7,11,12,14,10,10,9,3,17,3,DM C,1,1,1,1,1,1,1,1,1,20,15,1,1,1,1
54008555,Kamil Kostecki,787,23-07-1983,32,0,0,0,0,186,83,3,1,1,2,1,3,2,1,1,3,1,7,8,9,9,6,9,12,10,8,9,11,14,10,7,11,13,9,10,11,11,10,16,9,16,11,7,13,11,9,8,13,12,9,11,9,20,12,12,11,9,14,9,13,13,14,7,16,15,15,12,13,M/AM C,1,1,1,17,1,1,1,1,1,1,20,1,1,1,1
54008574,Michal Zawadzki,787,11-08-1987,28,0,0,0,0,175,74,3,2,2,1,1,1,2,1,2,3,4,9,9,7,3,8,12,7,3,9,11,7,3,10,8,9,10,11,9,9,9,9,9,9,12,8,9,12,11,11,12,8,7,8,6,11,20,11,9,10,9,10,9,5,16,10,14,11,11,11,14,4,D/WB R,1,1,1,1,1,1,1,1,20,1,1,1,1,1,17
54008645,Kamil Jackiewicz,787,25-11-1983,32,0,0,0,0,180,77,3,2,3,1,2,2,3,1,3,1,2,6,8,9,10,9,7,11,9,3,8,10,12,5,11,6,11,8,11,10,11,11,11,10,9,10,5,11,11,11,9,11,10,7,8,10,20,13,12,13,5,11,9,9,8,12,6,11,12,13,12,10,S ,1,1,20,10,12,10,1,1,1,1,1,1,1,1,1
54008646,Krystian Getinger,787,29-08-1988,27,0,0,0,0,185,75,3,1,1,1,2,1,2,1,2,3,3,13,9,9,10,9,11,12,12,8,10,10,12,10,9,11,10,11,10,12,10,12,4,10,12,10,9,10,10,12,10,9,12,20,11,12,7,13,10,11,8,10,6,10,9,12,11,10,12,5,20,4,D L,1,1,1,1,15,1,1,20,1,1,1,15,1,15,1
54008755,Rafal Pietrzak,787,30-01-1992,24,0,0,0,0,176,69,2,1,1,3,1,2,1,2,3,2,3,12,12,11,8,10,13,9,11,5,12,11,10,11,10,8,10,10,11,10,12,11,10,11,7,11,10,12,12,13,11,10,7,20,10,13,7,12,11,10,7,10,2,10,18,11,11,10,12,8,12,1,D/WB L,1,1,1,1,6,1,1,20,10,11,1,15,7,18,7
54008756,Dawid Ryndak,787,12-03-1989,27,0,0,0,0,177,68,1,3,1,1,1,3,3,3,1,4,3,10,11,9,7,10,7,7,8,8,7,9,9,7,10,9,10,10,9,9,8,10,9,8,7,11,6,11,13,13,11,10,8,7,12,13,20,12,9,12,6,11,6,7,16,11,11,11,10,1,11,8,M/AM R,1,1,1,1,1,18,1,1,1,1,1,1,20,1,1
54008811,Tomasz Wrobel,787,21-06-1990,26,0,0,0,0,189,79,14,9,10,4,10,14,8,14,9,6,6,1,1,3,3,1,5,1,2,3,1,1,3,2,3,9,9,12,5,9,5,11,6,2,9,3,9,8,7,11,11,8,13,6,5,12,20,7,12,6,4,9,5,9,18,11,11,11,11,11,11,6,GK ,20,1,1,1,1,1,1,1,1,1,1,1,1,1,1
54008818,Emil Drozdowicz,787,05-07-1986,29,0,0,0,0,178,72,2,1,2,2,1,3,3,1,1,3,1,8,9,10,11,11,7,12,8,4,4,10,10,4,11,7,11,10,12,11,8,11,10,11,8,12,8,13,13,13,11,10,10,10,7,12,20,10,11,12,5,12,4,12,11,16,6,10,14,10,10,7,S ,1,1,20,10,12,12,1,1,1,1,5,10,10,1,1
54008819,Kamil Hempel,787,12-05-1988,28,0,0,0,0,184,79,3,3,1,3,1,2,2,3,1,3,1,7,10,9,7,9,10,10,11,8,10,10,10,10,10,9,9,8,9,9,10,10,11,10,12,6,9,11,12,11,10,10,11,8,7,11,20,11,10,10,6,8,17,9,8,10,8,8,11,10,9,7,D/WB L,1,1,1,1,7,1,1,20,1,1,1,10,1,17,1
54008820,Krzysztof Kaczmarczyk,787,19-06-1980,36,0,0,0,0,180,75,3,2,1,3,2,3,3,2,1,3,3,9,7,10,6,11,8,11,9,6,11,12,5,11,9,10,12,12,11,12,11,13,12,7,11,9,11,12,11,9,11,11,8,7,10,10,20,10,11,12,10,13,4,6,10,10,11,9,14,10,9,8,DM/M C,1,1,1,10,1,1,1,1,1,19,20,1,1,1,1
54008822,Adrian Luszkiewicz,787,06-08-1986,29,0,0,0,0,179,74,3,1,2,1,1,3,3,4,3,3,1,5,11,8,5,8,13,9,10,7,11,12,9,9,8,15,10,14,10,11,9,11,9,6,9,10,11,14,14,11,10,11,11,20,12,10,9,13,13,11,13,11,6,10,10,10,13,8,10,10,11,5,DM/M C,1,1,1,1,1,1,7,1,1,20,17,1,1,1,1
54008830,Damian Szalas,787,26-02-1988,28,0,0,0,0,178,73,2,2,2,2,3,1,2,2,1,2,3,8,9,9,6,10,9,7,9,10,8,10,9,8,9,8,9,8,9,9,10,10,14,10,5,9,10,11,11,10,11,10,8,10,10,11,20,10,7,10,9,12,6,9,12,15,15,10,11,11,10,8,M R,1,1,1,1,1,10,1,1,1,1,1,1,20,1,1
54008833,Krzysztof Ziemniak,787,21-09-1984,31,0,0,0,0,180,68,3,2,1,3,1,3,3,2,1,2,2,5,9,11,6,11,5,11,7,9,12,11,11,11,11,8,9,9,10,11,11,10,9,7,7,7,10,13,11,10,10,11,11,8,11,10,20,10,9,13,9,12,6,11,10,8,10,10,10,9,11,5,D RC,1,1,1,1,1,1,17,1,20,1,1,1,1,1,1
54008909,Tomasz Margol,787,17-04-1989,27,0,0,0,0,185,77,1,1,3,2,1,2,2,2,2,1,2,6,10,9,7,10,10,9,11,9,9,10,5,10,11,14,10,14,9,14,10,10,15,6,14,7,10,12,13,9,9,11,12,9,14,10,20,12,12,11,6,12,5,10,10,14,5,11,10,1,7,5,DM/M/AM C,1,1,1,18,1,1,1,1,1,20,18,1,1,1,1
54008910,Vitaliy Melnychuk,800,03-10-1988,27,0,0,0,0,177,74,2,1,1,3,2,1,2,2,2,3,1,6,8,11,7,12,6,6,4,6,6,11,7,11,9,8,10,7,12,6,11,11,6,9,12,6,7,10,10,13,13,7,7,6,12,13,20,4,6,9,14,9,9,9,15,9,10,13,13,5,16,4,AM RC,1,1,5,20,1,20,1,1,1,1,15,1,15,1,1
54008915,Mateusz Prus,787,09-03-1990,26,0,0,1,0,187,78,11,11,8,8,11,12,10,11,9,7,12,1,1,1,1,9,5,2,2,1,1,10,1,2,9,9,8,12,9,10,10,8,14,2,7,1,10,9,7,9,13,9,12,6,7,9,20,12,11,9,7,9,3,9,13,15,13,10,10,13,6,8,GK ,20,1,1,1,1,1,1,1,1,1,1,1,1,1,1
54008921,Rafal Turczyn,787,08-12-1989,26,0,0,0,0,172,65,3,3,4,3,4,3,2,4,1,2,3,5,6,8,4,7,8,7,10,10,4,9,7,8,9,5,12,4,6,7,6,14,7,8,8,9,8,11,12,9,9,3,5,6,11,10,20,11,9,8,7,7,5,12,11,12,10,11,10,8,17,5,M/AM LC,1,1,15,1,18,10,1,1,1,1,16,20,10,1,10
54008991,Dariusz Dadacz,787,16-12-1982,33,0,0,0,0,183,80,3,1,4,2,3,2,1,1,1,3,4,2,7,5,3,9,3,10,3,11,11,9,5,11,8,10,10,11,9,11,5,10,9,2,10,8,13,13,12,10,7,12,10,20,8,11,6,12,13,8,12,10,9,5,14,11,8,14,9,5,13,2,D LC,1,1,1,1,1,1,20,20,1,1,1,1,1,1,1
54008998,Marcin Stanczyk,787,01-11-1983,32,0,0,0,0,188,80,3,3,3,4,3,1,1,3,3,1,1,11,9,7,9,9,9,11,7,5,8,11,7,6,8,13,10,11,7,11,8,11,5,6,12,8,11,12,10,10,7,13,13,8,8,10,20,12,14,12,9,12,12,5,14,14,13,9,12,3,18,4,AM/S C,1,1,20,18,1,1,1,1,1,1,15,1,1,1,1
54009000,Dominik Dukalski,787,12-08-1986,29,0,0,0,0,190,78,1,3,1,3,4,3,2,1,3,1,4,3,3,14,9,14,7,12,5,3,6,7,11,1,9,4,12,5,9,8,6,10,9,9,11,14,9,7,9,8,8,8,15,20,12,10,6,11,11,9,5,9,7,9,13,11,9,12,11,9,15,6,S ,1,1,20,1,1,1,1,1,1,1,1,1,1,1,1
54009010,Kamil Golebiewski,787,18-03-1988,28,0,0,0,0,195,90,13,12,13,1,10,12,10,9,6,9,7,3,2,2,1,1,6,1,2,2,3,1,2,3,4,9,9,9,8,9,6,14,9,1,2,1,9,8,7,8,7,14,17,7,9,8,20,4,15,11,5,7,5,9,19,14,10,11,12,6,15,8,GK ,20,1,1,1,1,1,1,1,1,1,1,1,1,1,1
54009012,Artur Banka,787,17-03-1986,30,0,0,0,0,179,73,2,2,3,3,2,1,3,2,2,3,3,5,4,4,6,9,5,4,8,1,7,10,9,7,12,4,7,7,8,6,9,12,9,13,9,7,7,6,11,12,12,6,2,7,10,12,20,12,9,12,7,6,9,9,14,11,9,11,11,8,17,2,M/AM C,1,1,1,18,1,1,1,1,1,1,20,1,1,1,1
54009065,Michal Stachurski,787,25-11-1988,27,0,0,0,0,183,73,2,1,3,1,3,1,3,3,3,2,1,4,6,6,9,8,5,11,5,9,8,8,4,9,7,14,12,11,12,13,13,11,8,12,11,9,11,14,13,8,11,10,11,7,12,12,20,9,9,12,9,13,9,4,11,6,9,2,8,7,3,4,D R,1,1,1,1,1,1,1,1,20,1,1,1,1,1,13
54009067,Tomasz Persona,787,24-03-1988,28,0,0,0,0,179,72,1,1,3,4,3,2,1,1,1,2,2,11,11,10,6,10,6,7,8,7,7,9,9,7,9,8,9,9,9,9,9,10,8,9,8,9,10,12,13,10,9,10,8,20,6,10,9,13,10,10,3,12,9,8,3,10,11,6,5,6,9,14,M/AM L,1,1,1,1,20,1,1,1,1,1,10,20,1,1,1
54009096,Gabriel Nowak,787,26-07-1986,29,0,0,0,0,187,84,1,4,1,3,3,3,2,3,3,2,4,8,8,9,8,8,8,11,12,8,9,12,10,10,10,10,10,8,10,10,10,11,10,12,10,6,11,10,11,9,9,12,15,7,12,9,20,10,12,10,10,12,16,11,7,10,11,14,14,14,12,8,D/DM/M C,1,1,1,7,1,1,17,1,1,17,20,1,1,1,1
54009099,Lukasz Skorupski,787,05-05-1991,25,1,0,5,0,187,84,13,11,8,12,13,12,13,17,11,10,12,7,1,3,2,6,12,5,2,2,3,7,4,1,7,15,14,17,13,11,4,11,15,10,12,9,13,12,13,14,15,12,14,7,14,13,20,12,16,14,12,13,5,12,12,14,11,11,14,14,11,5,GK ,20,1,1,1,1,1,1,1,1,1,1,1,1,1,1
54009106,Andrzej Witan,787,20-02-1990,26,0,0,0,0,182,76,10,11,10,10,11,12,13,12,14,10,9,6,1,1,1,7,8,3,3,2,2,5,1,3,9,9,10,10,10,10,10,10,12,7,7,3,12,11,12,9,11,11,10,5,12,10,20,11,11,9,8,13,8,9,14,12,12,14,11,13,9,8,GK ,20,1,1,1,1,1,1,1,1,1,1,1,1,1,1
54009327,Adam Banasiak,787,07-12-1989,26,0,0,1,0,185,76,2,1,4,1,3,3,3,3,2,3,2,12,12,9,6,9,12,11,13,10,7,9,12,8,9,11,9,12,8,9,11,11,10,10,12,11,10,11,12,11,12,10,10,20,14,10,8,14,14,9,11,11,1,14,9,12,13,11,8,8,14,6,DM/M LC,1,1,1,1,14,1,7,15,1,16,16,20,1,10,1
54009328,Lukasz Malkowski,787,15-07-1988,27,0,0,0,0,175,69,1,2,3,3,3,2,3,3,2,2,2,8,11,10,8,9,8,10,8,7,9,11,8,9,11,12,11,12,10,11,10,11,13,11,5,13,9,12,13,10,12,9,10,7,12,9,20,11,9,11,6,7,9,16,13,8,8,11,7,8,10,3,M/AM RLC,1,1,1,15,15,20,1,1,11,1,1,13,20,1,1
54009331,Patryk Kaminski,787,15-03-1991,25,0,0,0,0,174,64,1,1,1,1,2,1,1,3,1,2,1,10,9,10,6,11,8,5,8,5,7,12,6,6,11,14,9,9,8,10,11,9,8,12,10,10,8,12,12,11,11,8,8,8,12,10,20,12,8,10,11,10,5,12,10,7,14,10,12,12,10,5,M/AM C,1,1,1,20,13,10,1,1,1,1,17,10,7,1,1
54009333,Maciej Gorski,787,01-03-1990,26,0,0,1,0,183,75,3,1,1,3,2,1,1,1,2,3,1,5,6,10,12,9,5,12,10,3,6,10,11,7,10,8,11,11,12,12,11,13,9,9,5,13,9,12,13,11,10,11,11,13,13,12,20,12,11,11,12,8,10,5,7,10,14,7,12,11,12,3,S ,1,1,20,10,5,5,1,1,1,1,1,1,1,1,1
54009505,Mateusz Imianowski,787,06-07-1987,28,0,0,0,0,183,75,9,10,12,5,10,8,10,8,8,7,8,5,3,3,2,4,7,1,3,1,3,5,2,2,7,9,10,11,8,9,9,11,6,2,13,3,10,10,9,10,12,10,11,6,15,10,20,9,11,11,6,8,9,9,12,10,12,13,10,10,10,5,GK ,20,1,1,1,1,1,1,1,1,1,1,1,1,1,1
54009524,Adrian Basta,787,12-01-1988,28,0,0,11,0,180,77,3,3,1,3,3,3,3,2,4,4,1,6,12,9,6,11,5,10,10,5,10,12,6,11,10,13,12,12,9,12,9,12,12,7,9,10,10,14,14,10,12,11,9,11,14,10,20,12,11,11,11,12,7,8,9,14,11,9,15,12,7,4,D RL,1,1,1,1,1,1,1,15,20,1,1,1,13,10,13
54009525,Ariel Dzionsko,787,14-02-1990,26,0,0,0,0,173,69,1,1,3,4,3,1,2,2,3,3,2,8,8,5,6,9,4,10,8,7,9,7,3,8,8,5,11,10,7,10,3,14,9,8,5,5,10,9,10,10,10,7,6,20,4,12,6,14,6,9,9,7,9,9,17,11,11,13,11,10,19,1,D LC,1,1,1,1,1,1,15,20,1,1,1,1,1,5,1
54009628,Tomasz Walat,787,19-05-1982,34,0,0,0,0,184,79,2,2,3,1,3,1,3,2,2,1,1,7,9,9,9,10,9,11,5,7,9,10,14,9,9,9,8,10,12,8,9,9,3,9,14,8,9,11,10,11,9,10,9,8,11,10,20,11,11,12,8,13,5,16,8,9,9,11,9,4,19,7,D C,1,1,15,10,1,1,20,1,1,1,1,1,1,1,1
54009629,Jonasz Jezewski,787,19-08-1987,28,0,0,0,0,179,77,3,1,2,3,2,2,3,1,1,1,3,7,11,8,9,9,7,5,8,7,8,11,9,8,9,6,10,9,9,8,9,8,1,9,6,10,10,11,11,10,10,7,10,20,12,11,7,13,11,10,5,12,6,9,16,10,11,9,11,7,17,6,M/AM/S L,1,1,17,1,20,1,1,1,1,1,1,18,1,1,1
54009676,Rafal Krol,787,16-01-1989,27,0,0,0,0,183,71,3,1,3,3,1,1,2,1,4,3,3,9,7,9,8,10,8,8,11,6,6,11,13,6,9,14,9,9,9,10,11,11,12,9,8,10,9,12,12,9,10,9,9,9,10,10,20,12,10,12,14,10,7,6,8,11,12,11,10,8,8,12,M/AM C,1,1,1,19,1,1,1,1,1,10,20,1,1,1,1
54009868,Wojciech Malecki,787,11-10-1990,25,0,0,1,0,188,81,11,10,10,13,11,10,11,12,10,9,9,3,1,2,2,7,5,6,2,3,1,8,3,1,6,9,10,12,10,9,10,10,3,3,7,2,11,11,13,9,12,11,13,8,9,9,20,10,12,12,7,9,9,9,10,11,11,10,11,10,14,6,GK ,20,1,1,1,1,1,1,1,1,1,1,1,1,1,1
54009887,Ariel Famulski,787,26-09-1991,24,0,0,0,0,178,66,2,1,1,1,2,3,1,1,2,1,1,5,9,9,9,13,8,8,10,1,10,11,3,11,11,9,8,6,10,9,11,9,8,7,8,9,13,11,12,10,7,8,8,6,16,11,20,15,8,11,9,9,14,9,12,14,13,9,10,4,10,2,DM/M RC,1,1,1,1,1,1,1,1,1,20,18,1,15,1,1
54009888,Adrian Krysian,787,26-02-1990,26,0,0,0,0,176,65,2,2,1,2,1,2,1,1,3,3,2,7,11,11,9,12,7,6,5,7,7,7,4,4,11,7,10,4,9,6,8,14,9,10,5,8,7,12,13,11,10,8,7,6,12,11,20,14,10,9,7,4,9,9,13,14,13,13,12,1,17,1,AM RL,1,1,5,10,20,20,1,1,1,1,5,14,14,1,1
54009889,Michal Markowski,787,14-03-1990,26,0,0,0,0,185,75,3,1,4,2,3,1,3,3,1,4,3,8,5,7,6,9,5,13,10,9,12,11,9,11,9,12,10,11,10,9,10,10,7,8,8,5,12,11,12,11,11,11,12,8,10,11,20,12,11,11,10,9,6,10,8,13,10,14,8,12,13,3,D C,1,1,1,1,1,1,20,1,1,1,1,1,1,1,1
54009890,Pawel Oleksy,787,01-04-1991,25,0,0,6,0,182,77,3,2,1,1,2,3,3,1,3,2,3,10,11,9,8,10,9,10,9,9,10,10,9,11,9,10,10,12,11,11,11,11,12,9,9,11,10,12,13,12,11,10,11,20,12,12,7,14,11,12,12,14,10,9,14,13,11,11,11,10,15,2,D LC,1,1,1,1,1,1,15,20,13,7,1,7,7,10,10
54009891,Adrian Rakowski,787,07-10-1990,25,0,0,0,0,180,70,1,4,2,2,3,1,3,1,1,3,3,8,10,11,8,12,8,7,11,6,9,12,8,11,12,8,12,7,11,11,13,12,13,8,9,9,8,12,11,10,12,9,10,8,11,10,20,12,8,12,7,12,11,8,12,12,14,9,13,16,14,7,M C,1,1,1,6,1,1,1,1,1,15,20,1,1,1,1
54009894,Arkadiusz Wozniak,787,01-06-1990,26,1,0,3,1,184,68,1,2,3,3,3,1,2,1,1,2,1,7,8,10,11,10,7,14,9,9,5,10,11,9,10,16,9,15,9,12,9,9,15,10,14,11,8,13,16,11,12,14,13,8,14,11,20,13,13,11,13,13,9,9,17,11,18,12,15,12,16,7,M/AM/S R,1,1,20,13,13,17,1,1,1,1,7,13,17,1,1
54009904,Marcin Budzinski,787,06-07-1990,25,0,0,4,0,184,80,2,1,1,2,3,3,1,2,3,3,2,6,8,11,8,11,5,10,12,2,7,13,6,12,11,13,12,13,13,12,13,14,15,12,11,11,11,14,12,10,12,13,10,12,14,10,20,12,13,12,12,9,10,8,11,15,11,9,12,15,11,5,M/AM/S C,1,1,18,18,1,1,1,1,1,10,20,1,1,1,1
54009907,Hieronim Zoch,787,30-09-1990,25,0,0,0,0,183,79,6,12,11,11,6,12,11,10,9,11,13,2,2,1,3,6,4,2,1,2,1,11,1,2,12,9,10,9,13,11,8,13,5,2,10,2,9,12,8,12,13,7,11,7,15,11,20,4,9,9,9,9,9,9,18,12,10,11,11,11,16,7,GK ,20,1,1,1,1,1,1,1,1,1,1,1,1,1,1
54009912,Piotr Robakowski,787,01-05-1990,26,0,0,0,0,183,77,3,1,3,1,3,1,1,1,3,3,3,8,6,6,5,6,6,10,8,8,10,7,5,10,6,13,11,12,9,9,9,10,9,2,8,8,9,12,12,10,9,10,13,8,11,8,20,11,12,12,10,7,9,9,7,10,13,10,10,1,12,4,D C,1,1,1,1,1,1,20,1,14,1,1,1,1,1,1
54009919,Pawel Czoska,787,31-08-1990,25,0,0,2,0,181,71,3,1,2,2,3,1,3,2,1,3,3,7,7,9,7,10,8,6,8,3,7,13,8,7,11,8,11,10,11,9,10,10,9,9,9,9,9,12,11,11,11,9,8,12,11,11,20,11,10,11,6,11,10,11,12,13,12,10,8,5,16,3,M/AM C,1,1,1,17,1,1,1,1,1,15,20,1,1,1,1
54009926,Krzysztof Bulka,787,03-07-1990,25,0,0,0,0,170,66,3,3,2,3,3,1,2,1,1,3,2,12,10,10,8,9,9,6,7,6,7,9,13,6,11,12,9,12,9,8,10,9,5,9,11,10,8,10,10,10,10,9,6,11,13,10,20,9,9,11,11,9,10,12,8,9,11,11,13,7,7,1,AM/S RL,1,1,16,13,20,18,1,1,1,1,1,1,1,1,1
54009927,Lukasz Krzeminski,787,06-05-1986,30,0,0,0,0,182,78,2,3,1,2,1,1,3,3,1,3,2,9,10,10,9,9,9,9,7,3,9,10,6,7,10,10,9,11,9,10,9,9,14,13,9,10,9,9,9,10,10,10,10,10,15,9,20,9,10,11,7,9,6,12,12,9,11,9,12,3,15,2,M/AM/S RLC,1,1,17,15,15,20,1,1,1,1,1,1,20,1,1
54009929,Mariusz Ragaman,787,04-05-1986,30,0,0,0,0,181,78,4,2,2,1,1,2,1,2,1,3,1,6,8,6,5,7,6,10,9,6,10,8,7,10,8,15,9,11,11,9,9,9,7,10,9,11,10,12,12,10,7,10,10,8,4,10,20,12,11,11,12,1,8,10,10,8,11,6,10,10,10,10,D/WB/DM R,1,1,1,1,1,1,13,10,20,20,13,1,1,7,18
54009931,Janusz Gol,787,11-11-1985,30,8,0,0,0,182,77,3,3,3,1,2,2,3,2,2,1,1,9,10,12,9,13,10,11,12,5,14,12,13,12,14,9,16,10,12,15,14,12,12,13,8,10,14,14,13,12,11,12,11,8,12,12,20,12,10,13,7,11,8,11,13,12,10,11,12,12,13,7,DM/M C,1,1,7,13,1,1,1,1,1,20,19,1,1,1,1
54010002,Bartosz Kaniecki,787,11-07-1988,27,0,0,0,0,194,90,14,10,11,8,11,9,11,11,10,14,10,5,3,3,3,7,9,9,2,2,3,5,1,1,3,11,10,11,9,11,5,9,10,9,11,5,10,13,12,10,9,14,16,5,14,8,20,10,15,12,6,7,5,9,5,9,12,10,12,12,13,5,GK ,20,1,1,1,1,1,1,1,1,1,1,1,1,1,1
54010006,Robert Kowalczyk,787,31-10-1989,26,0,0,0,0,180,74,4,3,2,1,3,4,1,4,2,4,1,8,10,8,8,8,8,13,9,7,9,9,4,7,10,9,8,12,8,8,9,9,9,9,12,9,7,11,11,10,8,12,8,9,12,10,20,12,12,10,9,9,9,13,11,12,10,10,12,1,19,4,AM/S L,1,1,20,1,17,1,1,1,1,1,1,15,1,1,1
54010379,Marcin Matysiak,787,14-11-1991,24,0,0,0,0,188,87,10,9,8,5,12,9,11,12,7,5,11,2,2,2,1,8,7,3,3,2,3,9,2,2,10,7,10,9,9,9,9,8,11,9,6,2,9,10,10,9,10,11,14,8,10,9,20,10,13,12,10,10,9,8,12,12,10,9,11,10,13,12,GK ,20,1,1,1,1,1,1,1,1,1,1,1,1,1,1
54010382,Pawel Wicher,787,10-04-1990,26,0,0,0,0,191,85,2,4,3,3,1,3,1,2,3,3,1,8,8,9,9,9,8,10,7,6,9,10,7,9,11,8,9,8,9,10,11,8,8,8,6,10,8,10,10,9,10,9,13,10,10,9,20,10,9,9,11,8,8,14,8,12,13,10,13,9,12,8,M C,1,1,1,1,1,1,1,1,1,15,20,1,1,1,1
54010439,Pawel Waskow,787,02-07-1989,27,0,0,0,0,189,82,10,9,9,4,11,10,11,11,13,7,9,6,3,3,2,5,8,1,3,3,3,9,2,3,4,9,13,9,9,9,9,9,3,3,14,3,9,10,9,9,9,12,14,6,10,9,20,11,13,9,9,9,9,9,19,10,11,13,12,4,13,2,GK ,20,1,1,1,1,1,1,1,1,1,1,1,1,1,1
54010593,Dawid Tomanek,787,22-10-1990,25,0,0,0,0,186,75,1,1,1,1,3,1,4,1,1,4,1,6,8,11,8,13,6,9,4,6,6,4,3,6,8,6,10,7,9,5,5,10,9,9,3,11,5,7,8,8,12,7,12,9,9,9,20,9,10,11,9,9,7,9,19,12,12,10,11,5,12,1,AM/S RL,1,1,20,1,18,18,1,1,1,1,1,1,1,1,1
735216,Cristiano Ronaldo,788,05-02-1985,31,133,61,10,3,186,84,2,1,3,1,3,2,2,3,1,3,2,12,14,15,19,16,14,18,19,6,2,14,19,8,15,6,17,16,13,16,13,17,20,18,15,18,5,6,7,13,12,13,16,15,19,17,20,17,16,17,12,14,7,10,18,20,13,19,20,7,7,12,AM/S RL,1,1,19,8,20,15,1,1,1,1,1,15,10,1,1
735225,Leonel,788,09-11-1981,34,0,0,0,0,185,78,1,1,2,3,3,3,4,3,1,3,1,1,1,5,3,6,1,6,1,1,10,6,3,11,1,8,8,9,7,8,2,11,8,2,8,5,13,5,8,7,9,7,7,20,8,10,8,12,10,8,8,6,5,8,16,10,13,11,12,11,14,7,D LC,1,1,1,1,1,1,20,17,1,1,1,1,1,1,1
735229,Sandro Cunha,788,05-12-1982,33,0,0,0,0,188,80,2,3,3,2,1,2,3,3,3,2,1,7,6,5,6,8,4,15,4,10,14,8,8,12,6,14,13,11,12,12,5,11,12,3,13,9,12,11,11,9,9,15,15,7,12,10,20,13,15,12,12,11,7,3,12,11,13,11,13,13,13,6,D C,1,1,1,1,1,1,20,1,10,1,1,1,1,1,1
735320,Júlio Rebelo,788,29-03-1981,35,0,0,0,0,180,81,3,4,3,2,1,1,1,3,2,1,3,4,7,10,12,9,5,9,10,3,2,7,9,2,11,12,12,9,12,12,5,11,9,10,9,12,10,9,7,8,8,10,9,5,12,12,20,10,12,8,5,7,5,8,10,9,9,12,11,14,15,1,S ,1,1,20,1,1,1,1,1,1,1,1,1,1,1,1
735439,Filipe Faia,788,24-11-1981,34,0,0,0,0,193,88,2,2,3,1,2,1,2,2,1,1,2,3,7,7,6,9,5,11,7,4,11,10,6,11,10,13,11,10,11,10,7,8,16,8,14,4,11,11,13,10,10,11,12,5,11,9,20,11,13,9,6,9,5,7,14,15,17,12,12,12,10,4,D/DM C,1,1,1,1,1,1,17,1,1,20,10,1,1,1,1
735519,Alan,1651,19-09-1979,36,0,0,0,0,180,77,1,1,3,2,3,3,3,1,3,3,2,14,15,15,13,13,13,10,13,6,6,14,16,7,15,10,10,11,14,13,14,14,12,16,15,12,12,11,11,11,11,12,10,12,14,11,20,10,12,12,8,13,8,12,12,11,12,13,10,11,12,3,M/AM RC,1,1,7,15,14,20,1,1,1,1,1,8,18,1,1
735568,Pedro Alves,788,08-02-1979,37,0,0,1,0,188,80,12,14,13,5,10,12,12,13,10,12,10,5,1,1,1,2,10,5,1,3,2,8,3,3,6,5,12,11,13,11,11,8,12,3,11,3,12,10,12,8,11,11,12,5,14,10,20,11,12,13,10,16,9,10,18,5,15,11,15,4,17,5,GK ,20,1,1,1,1,1,1,1,1,1,1,1,1,1,1
735574,João Paulo,788,06-06-1981,35,0,0,12,1,180,81,2,1,3,3,1,2,2,1,2,2,2,6,6,8,7,10,7,15,7,10,15,10,8,14,7,12,12,13,11,11,7,12,15,7,13,5,14,14,12,12,8,15,12,10,13,11,20,13,16,14,12,12,14,12,12,14,14,12,14,16,16,3,D C,1,10,1,1,1,1,20,1,12,14,1,1,1,1,8
735576,Laranjeiro,788,18-01-1983,33,0,0,1,0,184,65,2,1,3,2,3,3,1,1,3,1,2,12,14,11,8,11,13,8,12,11,11,11,12,12,13,10,10,11,14,13,10,12,13,10,9,11,11,12,12,9,9,8,8,5,8,9,20,10,8,11,8,10,7,10,4,12,14,12,13,14,14,3,D RL,1,3,1,1,1,1,10,15,20,5,1,1,1,5,10
735593,Alex Dias,788,05-07-1985,30,0,0,0,0,170,65,3,1,2,2,1,3,3,3,3,2,2,10,10,12,10,11,10,7,10,7,6,11,9,5,13,8,7,9,11,8,10,10,13,10,8,10,9,10,11,12,12,11,5,20,11,11,5,9,8,9,9,9,8,9,12,14,11,11,10,9,8,11,AM L,1,1,13,13,20,13,1,1,1,1,1,7,1,1,1
735631,Julio Cesar,1651,20-10-1979,36,0,0,0,0,182,82,1,1,1,1,2,2,2,2,1,3,3,6,10,15,12,12,8,12,8,8,6,11,13,5,13,12,12,11,12,11,11,12,15,15,6,12,5,11,13,14,13,11,12,12,14,14,20,12,12,13,7,8,11,10,16,15,13,13,12,14,13,7,AM/S C,1,1,20,17,1,1,1,1,1,1,1,1,1,1,1
735690,Nuno Graxinha,788,19-06-1982,34,0,0,0,0,179,72,3,2,2,2,1,1,2,3,3,2,3,5,8,7,5,10,6,10,7,11,12,11,7,12,8,13,11,12,10,10,10,10,12,9,14,10,11,12,11,8,6,10,12,13,13,10,20,12,12,10,5,9,1,9,12,11,18,10,14,12,9,5,DM/M C,1,1,1,1,1,1,7,1,9,20,16,1,1,1,1
735796,Nuno Piloto,788,19-03-1982,34,0,0,0,0,177,73,3,2,1,1,2,2,4,3,4,2,2,10,10,10,8,11,10,9,8,10,10,12,11,10,12,11,10,12,15,14,11,13,13,6,15,10,13,16,14,9,9,10,9,5,8,9,20,8,10,17,7,15,13,14,8,11,16,12,16,18,18,3,DM/M C,1,1,1,1,1,1,1,1,5,20,20,1,1,1,1
735852,Joeano,1651,12-08-1979,36,0,0,0,0,174,72,3,2,3,3,3,2,3,3,1,3,3,5,8,13,14,12,9,13,12,5,5,11,13,4,13,13,13,9,12,11,10,14,14,13,6,13,5,13,7,9,13,11,10,5,12,9,20,10,8,11,9,12,6,6,16,15,14,15,11,15,13,4,S ,1,1,20,1,1,1,1,1,1,1,1,1,1,1,1
735881,Pedro Kané,788,19-12-1978,37,0,0,0,0,177,77,1,3,1,2,3,3,2,1,3,3,3,11,12,11,10,11,9,8,12,10,9,13,12,8,12,10,10,10,10,10,11,9,6,11,11,11,10,10,10,8,9,11,9,3,8,8,20,10,9,10,10,10,10,8,4,11,10,10,11,12,13,3,M C,1,1,1,1,1,1,1,1,1,1,20,1,1,1,1
